"filename", "language", "TypeScript", "TypeScript React", "CSS", "XML", "comment", "blank", "total"
"h:\work\_projects\react\volume-trainings\src\App.css", "CSS", 0, 0, 12, 0, 0, 0, 12
"h:\work\_projects\react\volume-trainings\src\App.tsx", "TypeScript React", 0, 62, 0, 0, 4, 26, 92
"h:\work\_projects\react\volume-trainings\src\assets\svg\arrow_downward_black_24dp.svg", "XML", 0, 0, 0, 1, 0, 0, 1
"h:\work\_projects\react\volume-trainings\src\assets\svg\close_black_24dp.svg", "XML", 0, 0, 0, 1, 0, 0, 1
"h:\work\_projects\react\volume-trainings\src\assets\svg\content_copy_black_24dp.svg", "XML", 0, 0, 0, 1, 0, 0, 1
"h:\work\_projects\react\volume-trainings\src\assets\svg\delete_outline_black_24dp-red.svg", "XML", 0, 0, 0, 1, 0, 0, 1
"h:\work\_projects\react\volume-trainings\src\assets\svg\delete_outline_black_24dp.svg", "XML", 0, 0, 0, 1, 0, 0, 1
"h:\work\_projects\react\volume-trainings\src\assets\svg\done_black_24dp.svg", "XML", 0, 0, 0, 1, 0, 0, 1
"h:\work\_projects\react\volume-trainings\src\assets\svg\edit_black_24dp.svg", "XML", 0, 0, 0, 1, 0, 0, 1
"h:\work\_projects\react\volume-trainings\src\assets\svg\keyboard_arrow_down_black_24dp.svg", "XML", 0, 0, 0, 1, 0, 0, 1
"h:\work\_projects\react\volume-trainings\src\assets\svg\menu_black_24dp.svg", "XML", 0, 0, 0, 1, 0, 0, 1
"h:\work\_projects\react\volume-trainings\src\components\footer\footer.css", "CSS", 0, 0, 5, 0, 1, 0, 6
"h:\work\_projects\react\volume-trainings\src\components\footer\footer.tsx", "TypeScript React", 0, 9, 0, 0, 2, 4, 15
"h:\work\_projects\react\volume-trainings\src\components\header\header.css", "CSS", 0, 0, 31, 0, 0, 1, 32
"h:\work\_projects\react\volume-trainings\src\components\header\header.tsx", "TypeScript React", 0, 48, 0, 0, 2, 5, 55
"h:\work\_projects\react\volume-trainings\src\components\home\home.css", "CSS", 0, 0, 6, 0, 1, 0, 7
"h:\work\_projects\react\volume-trainings\src\components\home\home.tsx", "TypeScript React", 0, 22, 0, 0, 4, 10, 36
"h:\work\_projects\react\volume-trainings\src\components\month\month.css", "CSS", 0, 0, 83, 0, 4, 3, 90
"h:\work\_projects\react\volume-trainings\src\components\month\month.tsx", "TypeScript React", 0, 81, 0, 0, 9, 15, 105
"h:\work\_projects\react\volume-trainings\src\components\options\options.css", "CSS", 0, 0, 152, 0, 21, 8, 181
"h:\work\_projects\react\volume-trainings\src\components\options\options.tsx", "TypeScript React", 0, 113, 0, 0, 5, 16, 134
"h:\work\_projects\react\volume-trainings\src\components\schedule\days-menu\days-menu.css", "CSS", 0, 0, 11, 0, 0, 0, 11
"h:\work\_projects\react\volume-trainings\src\components\schedule\days-menu\days-menu.tsx", "TypeScript React", 0, 21, 0, 0, 4, 7, 32
"h:\work\_projects\react\volume-trainings\src\components\schedule\ex-set\ex-set.css", "CSS", 0, 0, 76, 0, 0, 0, 76
"h:\work\_projects\react\volume-trainings\src\components\schedule\ex-set\ex-set.tsx", "TypeScript React", 0, 75, 0, 0, 2, 13, 90
"h:\work\_projects\react\volume-trainings\src\components\schedule\exercise\exercise.css", "CSS", 0, 0, 94, 0, 7, 2, 103
"h:\work\_projects\react\volume-trainings\src\components\schedule\exercise\exercise.tsx", "TypeScript React", 0, 157, 0, 0, 6, 26, 189
"h:\work\_projects\react\volume-trainings\src\components\schedule\menu-day\menu-day.css", "CSS", 0, 0, 116, 0, 2, 3, 121
"h:\work\_projects\react\volume-trainings\src\components\schedule\menu-day\menu-day.tsx", "TypeScript React", 0, 91, 0, 0, 4, 15, 110
"h:\work\_projects\react\volume-trainings\src\components\schedule\schedule.css", "CSS", 0, 0, 47, 0, 2, 3, 52
"h:\work\_projects\react\volume-trainings\src\components\schedule\schedule.tsx", "TypeScript React", 0, 90, 0, 0, 6, 15, 111
"h:\work\_projects\react\volume-trainings\src\components\schedule\stats\stats.css", "CSS", 0, 0, 157, 0, 16, 8, 181
"h:\work\_projects\react\volume-trainings\src\components\schedule\stats\stats.tsx", "TypeScript React", 0, 56, 0, 0, 2, 6, 64
"h:\work\_projects\react\volume-trainings\src\components\schedule\training-day\training-day.css", "CSS", 0, 0, 11, 0, 0, 0, 11
"h:\work\_projects\react\volume-trainings\src\components\schedule\training-day\training-day.tsx", "TypeScript React", 0, 15, 0, 0, 4, 5, 24
"h:\work\_projects\react\volume-trainings\src\components\schedule\training\training.css", "CSS", 0, 0, 172, 0, 11, 5, 188
"h:\work\_projects\react\volume-trainings\src\components\schedule\training\training.tsx", "TypeScript React", 0, 96, 0, 0, 6, 17, 119
"h:\work\_projects\react\volume-trainings\src\components\year-schedule\year-schedule.css", "CSS", 0, 0, 33, 0, 0, 1, 34
"h:\work\_projects\react\volume-trainings\src\components\year-schedule\year-schedule.tsx", "TypeScript React", 0, 41, 0, 0, 6, 10, 57
"h:\work\_projects\react\volume-trainings\src\constants\date-and-time.ts", "TypeScript", 53, 0, 0, 0, 4, 9, 66
"h:\work\_projects\react\volume-trainings\src\constants\index.ts", "TypeScript", 1, 0, 0, 0, 0, 0, 1
"h:\work\_projects\react\volume-trainings\src\index.css", "CSS", 0, 0, 185, 0, 21, 27, 233
"h:\work\_projects\react\volume-trainings\src\index.tsx", "TypeScript React", 0, 14, 0, 0, 0, 1, 15
"h:\work\_projects\react\volume-trainings\src\providers\index.ts", "TypeScript", 7, 0, 0, 0, 0, 1, 8
"h:\work\_projects\react\volume-trainings\src\providers\json-provider.ts", "TypeScript", 14, 0, 0, 0, 1, 4, 19
"h:\work\_projects\react\volume-trainings\src\providers\local-storage-provider.ts", "TypeScript", 28, 0, 0, 0, 0, 5, 33
"h:\work\_projects\react\volume-trainings\src\react-app-env.d.ts", "TypeScript", 0, 0, 0, 0, 1, 1, 2
"h:\work\_projects\react\volume-trainings\src\store\actions\app-options-actions.ts", "TypeScript", 40, 0, 0, 0, 0, 6, 46
"h:\work\_projects\react\volume-trainings\src\store\actions\days-actions.ts", "TypeScript", 10, 0, 0, 0, 0, 3, 13
"h:\work\_projects\react\volume-trainings\src\store\actions\exercises-actions.ts", "TypeScript", 25, 0, 0, 0, 0, 5, 30
"h:\work\_projects\react\volume-trainings\src\store\actions\index.ts", "TypeScript", 20, 0, 0, 0, 0, 3, 23
"h:\work\_projects\react\volume-trainings\src\store\actions\schedule-actions.ts", "TypeScript", 24, 0, 0, 0, 0, 5, 29
"h:\work\_projects\react\volume-trainings\src\store\actions\sets-actions.ts", "TypeScript", 32, 0, 0, 0, 0, 6, 38
"h:\work\_projects\react\volume-trainings\src\store\actions\trainings-actions.ts", "TypeScript", 25, 0, 0, 0, 0, 5, 30
"h:\work\_projects\react\volume-trainings\src\store\calculate-stats.ts", "TypeScript", 65, 0, 0, 0, 2, 7, 74
"h:\work\_projects\react\volume-trainings\src\store\create-schedule.ts", "TypeScript", 76, 0, 0, 0, 0, 11, 87
"h:\work\_projects\react\volume-trainings\src\store\index.ts", "TypeScript", 6, 0, 0, 0, 6, 2, 14
"h:\work\_projects\react\volume-trainings\src\store\reducers\app-options-reducer.ts", "TypeScript", 62, 0, 0, 0, 0, 9, 71
"h:\work\_projects\react\volume-trainings\src\store\reducers\index.ts", "TypeScript", 10, 0, 0, 0, 0, 3, 13
"h:\work\_projects\react\volume-trainings\src\store\reducers\reducers-utils.ts", "TypeScript", 13, 0, 0, 0, 0, 3, 16
"h:\work\_projects\react\volume-trainings\src\store\reducers\week-schedule-reducer.ts", "TypeScript", 226, 0, 0, 0, 7, 21, 254
"h:\work\_projects\react\volume-trainings\src\store\state.ts", "TypeScript", 43, 0, 0, 0, 5, 10, 58
"h:\work\_projects\react\volume-trainings\src\store\types.ts", "TypeScript", 50, 0, 0, 0, 0, 11, 61
"h:\work\_projects\react\volume-trainings\src\utils\date-utils.ts", "TypeScript", 104, 0, 0, 0, 0, 22, 126
"h:\work\_projects\react\volume-trainings\src\utils\generate-id.ts", "TypeScript", 34, 0, 0, 0, 9, 8, 51
"h:\work\_projects\react\volume-trainings\src\utils\schedule-utils.ts", "TypeScript", 53, 0, 0, 0, 9, 10, 72
"Total", "-", 1021, 991, 1191, 9, 196, 422, 3830