"filename", "language", "CSS", "TypeScript", "TypeScript React", "XML", "comment", "blank", "total"
"h:\work\_projects\react\volume-trainings\src\App.css", "CSS", 13, 0, 0, 0, 0, 0, 13
"h:\work\_projects\react\volume-trainings\src\App.tsx", "TypeScript React", 0, 0, 53, 0, 4, 20, 77
"h:\work\_projects\react\volume-trainings\src\assets\svg\arrow_downward_black_24dp.svg", "XML", 0, 0, 0, 1, 0, 0, 1
"h:\work\_projects\react\volume-trainings\src\assets\svg\close_black_24dp.svg", "XML", 0, 0, 0, 1, 0, 0, 1
"h:\work\_projects\react\volume-trainings\src\assets\svg\content_copy_black_24dp.svg", "XML", 0, 0, 0, 1, 0, 0, 1
"h:\work\_projects\react\volume-trainings\src\assets\svg\delete_outline_black_24dp-red.svg", "XML", 0, 0, 0, 1, 0, 0, 1
"h:\work\_projects\react\volume-trainings\src\assets\svg\delete_outline_black_24dp.svg", "XML", 0, 0, 0, 1, 0, 0, 1
"h:\work\_projects\react\volume-trainings\src\assets\svg\done_black_24dp.svg", "XML", 0, 0, 0, 1, 0, 0, 1
"h:\work\_projects\react\volume-trainings\src\assets\svg\edit_black_24dp.svg", "XML", 0, 0, 0, 1, 0, 0, 1
"h:\work\_projects\react\volume-trainings\src\assets\svg\keyboard_arrow_down_black_24dp.svg", "XML", 0, 0, 0, 1, 0, 0, 1
"h:\work\_projects\react\volume-trainings\src\assets\svg\menu_black_24dp.svg", "XML", 0, 0, 0, 1, 0, 0, 1
"h:\work\_projects\react\volume-trainings\src\components\footer\footer.css", "CSS", 5, 0, 0, 0, 1, 0, 6
"h:\work\_projects\react\volume-trainings\src\components\footer\footer.tsx", "TypeScript React", 0, 0, 9, 0, 2, 4, 15
"h:\work\_projects\react\volume-trainings\src\components\header\header.css", "CSS", 30, 0, 0, 0, 0, 0, 30
"h:\work\_projects\react\volume-trainings\src\components\header\header.tsx", "TypeScript React", 0, 0, 36, 0, 2, 5, 43
"h:\work\_projects\react\volume-trainings\src\components\options\options.css", "CSS", 121, 0, 0, 0, 4, 5, 130
"h:\work\_projects\react\volume-trainings\src\components\options\options.tsx", "TypeScript React", 0, 0, 85, 0, 5, 16, 106
"h:\work\_projects\react\volume-trainings\src\components\schedule\ex-set\ex-set.css", "CSS", 76, 0, 0, 0, 0, 0, 76
"h:\work\_projects\react\volume-trainings\src\components\schedule\ex-set\ex-set.tsx", "TypeScript React", 0, 0, 80, 0, 2, 16, 98
"h:\work\_projects\react\volume-trainings\src\components\schedule\exercise\exercise.css", "CSS", 105, 0, 0, 0, 5, 1, 111
"h:\work\_projects\react\volume-trainings\src\components\schedule\exercise\exercise.tsx", "TypeScript React", 0, 0, 149, 0, 6, 23, 178
"h:\work\_projects\react\volume-trainings\src\components\schedule\schedule.css", "CSS", 147, 0, 0, 0, 4, 9, 160
"h:\work\_projects\react\volume-trainings\src\components\schedule\schedule.tsx", "TypeScript React", 0, 0, 105, 0, 4, 13, 122
"h:\work\_projects\react\volume-trainings\src\components\schedule\stats\stats.css", "CSS", 156, 0, 0, 0, 8, 13, 177
"h:\work\_projects\react\volume-trainings\src\components\schedule\stats\stats.tsx", "TypeScript React", 0, 0, 56, 0, 2, 6, 64
"h:\work\_projects\react\volume-trainings\src\components\schedule\training-day\training-day.css", "CSS", 11, 0, 0, 0, 0, 0, 11
"h:\work\_projects\react\volume-trainings\src\components\schedule\training-day\training-day.tsx", "TypeScript React", 0, 0, 28, 0, 4, 5, 37
"h:\work\_projects\react\volume-trainings\src\components\schedule\training\training.css", "CSS", 176, 0, 0, 0, 11, 5, 192
"h:\work\_projects\react\volume-trainings\src\components\schedule\training\training.tsx", "TypeScript React", 0, 0, 122, 0, 6, 16, 144
"h:\work\_projects\react\volume-trainings\src\constants\days-of-week.ts", "TypeScript", 0, 2, 0, 0, 0, 1, 3
"h:\work\_projects\react\volume-trainings\src\constants\index.ts", "TypeScript", 0, 1, 0, 0, 0, 0, 1
"h:\work\_projects\react\volume-trainings\src\constants\paths.ts", "TypeScript", 0, 0, 0, 0, 0, 1, 1
"h:\work\_projects\react\volume-trainings\src\index.css", "CSS", 105, 0, 0, 0, 8, 6, 119
"h:\work\_projects\react\volume-trainings\src\index.tsx", "TypeScript React", 0, 0, 14, 0, 0, 1, 15
"h:\work\_projects\react\volume-trainings\src\react-app-env.d.ts", "TypeScript", 0, 0, 0, 0, 1, 1, 2
"h:\work\_projects\react\volume-trainings\src\store\actions\app-options-actions.ts", "TypeScript", 0, 79, 0, 0, 0, 10, 89
"h:\work\_projects\react\volume-trainings\src\store\actions\exercises-actions.ts", "TypeScript", 0, 83, 0, 0, 0, 11, 94
"h:\work\_projects\react\volume-trainings\src\store\actions\index.ts", "TypeScript", 0, 13, 0, 0, 2, 4, 19
"h:\work\_projects\react\volume-trainings\src\store\actions\schedule-actions.ts", "TypeScript", 0, 21, 0, 0, 0, 4, 25
"h:\work\_projects\react\volume-trainings\src\store\actions\sets-actions.ts", "TypeScript", 0, 88, 0, 0, 0, 11, 99
"h:\work\_projects\react\volume-trainings\src\store\actions\trainings-actions.ts", "TypeScript", 0, 77, 0, 0, 0, 10, 87
"h:\work\_projects\react\volume-trainings\src\store\calculate-stats.ts", "TypeScript", 0, 59, 0, 0, 2, 7, 68
"h:\work\_projects\react\volume-trainings\src\store\create-schedule.ts", "TypeScript", 0, 76, 0, 0, 0, 11, 87
"h:\work\_projects\react\volume-trainings\src\store\index.ts", "TypeScript", 0, 6, 0, 0, 6, 2, 14
"h:\work\_projects\react\volume-trainings\src\store\reducers\app-options-reducer.ts", "TypeScript", 0, 62, 0, 0, 0, 9, 71
"h:\work\_projects\react\volume-trainings\src\store\reducers\index.ts", "TypeScript", 0, 10, 0, 0, 0, 3, 13
"h:\work\_projects\react\volume-trainings\src\store\reducers\reducers-utils.ts", "TypeScript", 0, 13, 0, 0, 0, 3, 16
"h:\work\_projects\react\volume-trainings\src\store\reducers\training-day-reducer.ts", "TypeScript", 0, 76, 0, 0, 0, 9, 85
"h:\work\_projects\react\volume-trainings\src\store\reducers\week-schedule-reducer.ts", "TypeScript", 0, 222, 0, 0, 6, 18, 246
"h:\work\_projects\react\volume-trainings\src\store\state.ts", "TypeScript", 0, 10, 0, 0, 0, 4, 14
"h:\work\_projects\react\volume-trainings\src\store\types.ts", "TypeScript", 0, 39, 0, 0, 0, 8, 47
"h:\work\_projects\react\volume-trainings\src\utils\generate-id.ts", "TypeScript", 0, 34, 0, 0, 9, 8, 51
"h:\work\_projects\react\volume-trainings\src\utils\tuple.ts", "TypeScript", 0, 4, 0, 0, 0, 2, 6
"Total", "-", 945, 975, 737, 9, 104, 301, 3071